/* Level 2 */

############<############
#@....#...........#....o#
#.###.#.#########.#.###.#
#.#...................#.#
#.#.###.###   ###.###.#.#
#.#.....# X X X #.....#.#
#...###.#   O   #.###...#
#.#.....# X X X #.....#.#
#.#.###.#########.###.#.#
#.#...................#.#
#.###.#.#########.#.###.#
#o....#...........#....o#
############>############
