/* Level 3 */

#########################
#O....#...........#....O#
#..@..#.#########.#..X..#
#.....#...........#.....#
###<###.###   ###.###>###
#.......# o o o #.......#
#.#####.#   X   #.#####.#
#.......# o o o #.......#
###.###.#########.###.###
#.....#...........#.....#
#..X..#.#########.#..X..#
#O....#...........#....O#
#########################
