/* Level 4 */

#####################
#X........X........X#
#...................#
#...................#
#X...<....@....>...X#
#...................#
#...................#
#X........X........X#
#####################
