/* Level 6 */

#########################
#@#...#...#.X.#...#...#.#
<.#.#.#.#.#.#.#.#.#.#.#.#
#...#...#...#...#...#...#
######X###########X######
#...#...#...#...#...#...#
#.#.#.#.#.#.#.#.#.#.#.#.>
#.#...#...#.X.#...#...#.#
#########################
