/* Level 9 */

@PACMAN_STEP_RATE 0.2
@GHOST_STEP_RATE 0.2

#######################
#@.........#.........O#
#.###.####.#.####.###.#
#o.........#.........o#
#####.#....O....#.#####
    #.#.#######.#.#
#####.#...X#X...#.#####
<.....####.#.####.....>
#####.#...X#X...#.#####
    #.#.#######.#.#
#####.#....O....#.#####
#o.........#.........o#
#.###.####.#.####.###.#
#O.........#.........O#
#######################
